##################################################################
############################################# ################   $
#################################             ################ ###
############################################# ################ ###
############                ################# ################ ###
################## ######## ################# ################ ###
################## ######## #######           ################ ###
################## ######## ####### ######### ################ ###
################## ######## ####### ######### ################ ###
################## ######## ####### ######### ################ ###
################## ######## ####### ######### ################ ###
################## ########                               #### ###
########################### ############ ########### ######### ###
##### ##################### ############ ########### ######### ###
##### ##################### ############ ########### ######### ###
##### ##################### ############ ########### ######### ###
##### ##################### ############ ########### ######### ###
#####                            ####### ########### ######### ###
##### ################################## ########### ######### ###
##### ################################## ########### ######### ###
##### ################################## ########### ######### ###
##### ################################## ########### ######### ###
##### ################################## ########### ######### ###
##### ##################################                       ###
##### ############################################## #############
##### ############################################## #############
#####                                                #############
##### ############################################################
##### ############################################################
